#E#########
# # # #   #
# # # # ###
#         #
### ### # #
#   # # # #
##### # ###
#   #   # #
# ### ### #
#         S
###########