XEXXXXXXXXXXXXXXX
X   X       X   X
XXX X XXX X XXX X
X   X X X X   X X
X XXX X X XXX X X
X X   X X X     X
X X XXX X XXXXX X
X       X X   X X
XXXXXXXXX X X XXX
X         X X   X
X XXXXXXXXX XXX X
X X   X       X X
X X X X XXXXXXX X
X X X X   X   X X
X X X X XXX X X X
X   X   X   X X X
X XXXXXXX XXX X X
X       X X     X
XXXXXXXXXSXXXXXXX