#########S#######################
# # # # #   # # #   #     # #   #
# # # # # ### # # ####### # # ###
#       #   #   # # # # # #     #
##### ### ### ### # # # # # #####
#     # #   # # #   #   #       #
##### # # ### # # ### ### ### ###
# #   # #         # #   #   # # #
# ### # # ######### # ### ##### #
# # #     # # # # #     #     # #
# # ##### # # # # # ##### ##### #
# # # #           #   # # #   # #
# # # ### ######### ### # # ### #
#   # #         # # # #       # #
### # ### ####### # # # ####### #
#       # # #   # # #   # # # # #
##### ### # # ### # # ### # # # #
#     #   #     #       #       #
######### ### ###################
#                           # # #
### # # # # ### # # # # # # # # #
#   # # # #   # # # # # # # # # #
### ##### # ### ### ### ##### # #
#     #   #   #   # #       # # #
### ### # # ### ####### ### ### #
#     # # #   #     # #   #   # #
### # ### # ### # ### ###########
#   #   # # #   #               #
# # # # ### ### # ##### # #######
# # # #   # #   #     # #       #
### ### # # ### ######### #######
#     # # # #         #         #
#########E#######################